2
2
0 0
20 20
- - - - - - - - 0 0 0 0 - - - - - - - -
- - - - - - - - 0 0 0 0 - - - - - - - -
- - - - - - - - 0 0 0 0 - - - - - - - -
- - - - - - - - 0 0 0 0 - - - - - - - -
- - - - 0 0 0 0 i 0 0 0 0 0 0 0 - - - -
- - - - 0 0 0 0 0 0 0 0 0 0 0 0 - - - -
- - - - 0 0 0 0 0 0 0 0 0 0 0 0 - - - -
- - - - 0 0 0 0 0 0 0 0 0 0 0 0 - - - -
0 0 0 0 0 0 0 0 0 0 0 0 0 0 0 c 0 0 0 0
0 0 0 0 0 0 0 0 0 1 2 0 0 0 0 0 0 0 0 0
0 0 0 0 0 0 0 0 0 2 1 0 0 0 0 0 0 0 0 0
0 0 0 0 c 0 0 0 0 0 0 0 0 0 0 0 0 0 0 0
- - - - 0 0 0 0 0 0 0 0 0 0 0 0 - - - -
- - - - 0 0 0 0 0 0 0 0 0 0 0 0 - - - -
- - - - 0 0 0 0 0 0 0 0 0 0 0 0 - - - -
- - - - 0 0 0 0 0 0 0 i 0 0 0 0 - - - -
- - - - - - - - 0 0 0 0 - - - - - - - -
- - - - - - - - 0 0 0 0 - - - - - - - -
- - - - - - - - 0 0 0 0 - - - - - - - -
- - - - - - - - 0 0 0 0 - - - - - - - -