4
10
10 2
50 49
0 0 0 0 0 0 0 0 - 0 0 0 0 0 0 0 0 0 0 0 0 0 0 0 0 0 0 0 0 0 0 0 0 0 - 0 0 0 0 - 0 - 0 0 0 - 0 0 0 
0 0 0 0 - 0 0 0 - 0 0 0 0 0 0 0 - - - - 0 - 0 0 0 0 - 0 0 0 0 0 0 0 - 0 0 - - 0 0 0 0 0 - - 0 0 0 
0 - - 0 - 0 0 0 - 0 0 - - 0 0 0 - - - - 0 0 0 0 0 - - - 0 - 0 - - 0 - 0 0 - - - - 0 0 - 0 0 - 0 - 
0 - - 0 - 0 0 0 - - - - - 0 0 0 - - - - 0 - 0 - 0 0 - - 0 - 0 0 - - - 0 - 0 0 0 - - 0 0 0 0 0 0 0 
0 - - - - - - - - 0 0 - - 0 0 0 - - - - 0 - - 0 0 - 0 0 - 0 0 0 0 0 0 0 0 0 0 0 0 - - 0 0 0 - 0 - 
0 - - 0 0 - 0 0 - 0 0 - - 0 0 0 0 0 0 0 0 - 0 0 0 0 0 0 0 0 - - 0 0 0 0 0 0 0 0 - 0 0 - 0 0 0 - - 
0 - - 0 0 - 0 0 - 0 0 0 0 - - 0 0 0 0 0 0 - - 0 0 0 0 - 0 0 0 - 0 0 0 - 0 - - - 0 0 0 - 0 0 - - 0 
0 0 0 0 0 - 0 0 - 0 - 0 0 - - 0 0 0 0 0 0 - - - - 0 0 - - 0 - - 0 0 0 - - - 0 0 0 - 0 - 0 - 0 0 0 
0 0 0 0 0 - 0 0 0 0 0 0 0 - - 0 0 0 0 0 0 0 0 - 0 0 0 0 0 - 0 0 0 0 - 0 0 0 0 0 - 0 0 0 0 0 0 0 0 
0 - - - - - - - - - - - - - - - - - - - - - - - - - - - - - - - - - - - - - - - - - - - - - - - 0 
0 - 0 0 0 0 0 - 0 0 0 0 0 - 0 0 0 0 0 0 0 0 0 0 0 0 0 0 0 0 0 0 0 0 0 0 0 0 0 0 0 0 0 0 0 0 0 0 0 
0 - 0 0 0 0 0 - 0 0 0 0 0 - 0 0 0 0 0 0 0 0 - - - - - 0 0 - - 0 0 0 0 0 0 0 0 0 0 0 0 0 0 0 0 0 0 
0 - 0 0 0 0 0 - 0 0 0 0 0 - 0 0 0 0 0 0 0 0 0 0 0 - - 0 0 - - - 0 0 0 0 0 0 0 0 0 0 0 0 0 0 0 b 0 
0 - 0 0 0 0 0 - 0 0 0 0 0 0 0 0 0 0 0 0 0 - - - - 0 - 0 0 - - - - 0 0 0 0 0 0 0 0 0 0 0 0 0 0 0 0 
0 - 0 0 0 0 0 - 0 0 0 0 0 0 0 0 0 0 0 0 - - - - - 0 - 0 0 - - - - - 0 0 0 0 0 0 0 - 0 0 0 0 0 0 0 
0 - 0 0 0 0 0 - 0 0 0 0 0 0 0 0 0 0 0 - - - 0 0 - 0 - 0 0 - - 0 - - - 0 0 0 0 0 0 - 0 0 0 0 0 0 0 
0 - 0 0 0 0 0 0 0 0 0 0 0 0 0 0 0 0 - - - 0 0 - - 0 - 0 0 - 0 0 0 - - - 0 0 0 0 0 - 0 0 0 0 0 0 0 
0 - 0 0 0 0 0 0 0 0 - - - - - - - - - - - 0 - - - 0 - - - - - 0 - - - - - - 0 0 0 - 0 0 0 0 b 0 0 
0 - 0 0 0 0 0 0 0 0 - 0 0 0 0 0 0 0 0 0 0 0 0 0 0 0 0 0 0 0 0 0 0 0 0 0 0 0 0 0 0 - - 0 0 0 0 0 0 
0 - 0 0 0 0 0 0 0 0 - 0 0 0 0 0 0 0 0 0 0 0 0 0 0 0 0 0 0 0 0 0 0 0 0 0 0 0 0 0 0 0 - 0 0 0 0 0 0 
0 - 0 0 0 0 0 0 0 0 - 0 0 0 0 0 0 0 0 0 0 0 0 0 0 0 0 0 0 0 0 0 0 0 0 0 0 0 0 0 0 0 - - 0 0 0 0 0 
0 - 0 - - - 0 0 0 0 - 0 0 0 0 0 0 0 0 0 0 0 0 0 0 0 0 0 0 0 0 0 0 0 - 0 0 0 0 0 0 0 - 0 0 0 0 0 0 
0 - 0 - 0 0 0 0 0 0 - 0 0 0 0 0 0 0 0 - 0 - 0 - 0 - - 0 - - - 0 0 0 - 0 0 0 0 0 0 - - 0 0 0 0 0 0 
0 - 0 - - - 0 - - - - - - - 0 0 0 0 0 - - - - - - - - - - - - 0 0 0 - 0 0 0 0 0 0 - 0 0 0 0 0 0 0 
0 - 0 - 0 0 0 - - - - - 0 0 0 0 0 0 0 0 - b 0 0 0 0 0 0 0 0 0 0 0 0 - 0 0 0 0 0 0 - 0 0 0 0 0 0 0 
0 - 0 - - - 0 0 0 0 - 0 0 0 0 0 0 0 0 - - 0 0 0 0 0 0 0 0 0 0 0 0 0 - 0 0 0 0 0 0 - 0 0 0 0 0 0 0 
0 - 0 - 0 0 0 - 0 0 - 0 0 0 0 0 0 0 0 0 - 0 0 0 0 0 0 0 0 0 0 0 0 0 - 0 0 0 0 0 0 b - 0 0 0 0 0 0 
0 - 0 - - - 0 - 0 - - 0 0 0 0 0 0 0 0 - - 0 0 0 0 2 1 4 3 0 0 0 0 0 - 0 0 0 0 0 0 - - - 0 0 0 0 0 
0 - 0 - 0 0 0 0 0 0 - 0 0 0 0 0 0 0 0 - - 0 0 0 0 1 4 3 2 0 0 0 0 0 - 0 0 0 0 0 0 b - 0 0 0 0 0 0 
0 - 0 - - - 0 - 0 0 - 0 0 0 0 0 0 0 0 0 - 0 0 0 0 4 3 2 1 0 0 0 0 0 - 0 0 0 0 0 0 - 0 0 0 0 0 0 0 
0 - 0 - 0 0 0 - 0 - - 0 0 0 0 0 0 0 0 - - 0 0 0 0 3 2 1 4 0 0 0 0 0 - 0 0 0 0 0 0 - 0 0 0 0 0 0 0 
0 - 0 - - - 0 - 0 0 - 0 0 0 0 0 0 0 0 0 - 0 0 0 0 0 0 0 0 0 0 0 0 0 - 0 0 0 0 0 0 - 0 0 0 0 0 0 0 
0 - 0 - 0 0 0 0 0 0 - 0 0 0 0 0 0 0 0 0 0 0 0 0 0 0 0 0 0 0 0 0 0 0 0 0 0 0 0 0 0 - 0 0 0 x 0 0 0 
0 - 0 - - - 0 - 0 - - 0 0 0 0 0 0 0 0 0 0 0 0 0 0 0 0 0 0 0 0 0 0 0 - 0 0 0 0 0 0 - 0 0 x x x 0 0 
0 - 0 - 0 0 0 - 0 0 - 0 0 0 0 0 0 0 0 0 0 0 0 0 - 0 0 0 0 0 0 - 0 x - 0 0 0 0 0 x - 0 0 0 x 0 0 0 
0 - 0 - - - 0 - 0 x - 0 0 0 0 0 0 0 - - - - - - - - - - - - - 0 - - - 0 0 0 0 - - - 0 0 0 0 0 0 0 
0 - 0 0 0 0 0 0 0 0 x - 0 0 0 0 0 0 0 0 0 0 0 0 0 0 0 x - 0 0 0 0 0 0 0 0 0 0 0 x - 0 0 0 0 0 0 0 
0 - 0 0 0 0 0 0 0 0 - - - - 0 0 0 0 0 0 0 0 0 0 0 0 0 0 0 0 0 0 0 0 0 0 0 0 0 0 0 - 0 0 0 0 0 0 0 
0 - 0 0 0 0 0 0 0 0 - 0 0 0 0 0 0 0 0 0 0 0 0 0 0 0 0 0 0 0 0 0 0 0 0 0 0 0 0 0 0 - 0 0 0 0 0 0 0 
0 - 0 0 0 0 0 0 0 0 - 0 0 0 0 0 0 0 0 0 0 0 0 0 0 0 0 0 0 0 0 0 0 0 0 0 0 0 0 0 0 - 0 0 0 x 0 0 0 
0 - 0 0 0 0 0 0 0 0 0 0 0 0 0 0 0 0 0 0 0 0 0 0 0 0 0 0 0 0 0 0 0 0 0 0 0 0 0 0 0 - - 0 x x x 0 0 
0 - 0 0 0 0 0 0 0 0 0 0 0 0 0 0 0 0 0 0 0 0 0 0 0 0 0 0 0 0 0 0 0 0 0 0 0 0 0 0 0 - 0 0 0 x 0 0 0 
0 - 0 0 0 0 0 0 0 0 0 0 0 0 0 0 0 0 0 0 0 0 0 0 0 0 0 0 0 0 0 0 0 0 0 0 0 0 0 0 0 - 0 0 0 0 0 0 0 
0 - 0 0 0 0 0 0 - x 0 0 0 0 - 0 - 0 0 0 0 0 - x 0 0 0 0 - 0 0 0 0 - x 0 0 0 0 0 x - 0 0 0 0 0 0 0 
0 0 0 0 - - - - - - - - - - - - - - - - - - - - - - - - - - - - - - - - - - - - - - 0 0 0 0 0 0 0 
0 0 0 0 0 0 0 0 0 0 0 x - x 0 0 0 0 0 0 0 0 0 0 x - x 0 0 0 0 0 0 0 0 0 0 0 0 0 0 0 0 0 0 x 0 0 0 
0 0 0 0 0 0 0 0 0 0 0 0 0 0 0 0 0 0 0 0 0 0 0 0 0 0 0 0 0 0 0 0 0 0 0 0 0 0 0 0 0 0 0 0 x x x 0 0 
0 0 0 0 0 0 0 0 0 0 0 0 0 0 0 0 0 0 0 0 0 0 0 0 0 0 0 0 0 0 0 x 0 0 0 0 0 0 0 x 0 0 0 0 0 x 0 0 0 
0 0 0 0 0 0 0 x 0 0 0 0 0 x 0 0 0 0 0 x 0 0 0 0 0 0 x 0 0 0 x x x 0 0 0 0 0 x x x 0 0 0 0 0 0 0 0 
x 0 0 0 0 0 0 0 0 0 0 0 0 0 0 0 0 0 0 0 0 0 0 0 0 0 0 0 0 0 0 x 0 0 0 0 0 0 0 x 0 0 0 0 0 0 0 0 x 
48 16 1 <-> 48 18 3
48 24 1 <-> 48 29 1
48 35 1 <-> 48 39 3
48 46 1 <-> 45 49 5
15 8 5 <-> 2 10 7
9 22 3 <-> 2 22 6
10 40 0 <-> 2 40 6
3 44 2 <-> 1 44 0
42 44 6 <-> 41 45 7
35 45 7 <-> 24 45 1
16 45 7 <-> 21 49 3
27 49 4 <-> 12 49 4
39 49 3 <-> 35 49 5
