2
3
2 0
6 8
0 0 0 0 0 0 0 0
0 0 b b b b 0 0
0 0 b 1 2 i 0 0
0 0 b 2 1 b 0 0
0 0 b b b b 0 0
0 0 0 0 0 0 0 0