2
3
2 0
6 8
0 0 0 0 0 0 0 0
0 0 0 0 0 0 0 0
0 0 0 1 2 i 0 0
0 0 0 2 1 0 0 0
0 0 0 0 0 0 0 0
0 0 0 0 0 0 0 0