2
3
2 0
10 8
- - - 0 - - - -
- - - - - - - -
0 0 0 0 0 0 0 0
0 0 0 0 0 0 0 0
0 0 0 1 2 0 0 0
0 0 0 2 1 0 0 0
0 0 0 0 0 0 0 0
0 0 0 0 0 0 0 0
- - - - - - - -
- - - - 0 - - -
3 0 7 <-> 0 2 0
3 0 6 <-> 1 2 0
3 0 5 <-> 2 2 0
3 0 4 <-> 3 2 0
3 0 3 <-> 4 2 0
3 0 2 <-> 5 2 0
3 0 1 <-> 6 2 0
3 0 0 <-> 7 2 0
4 9 3 <-> 7 7 4
4 9 2 <-> 6 7 4
4 9 1 <-> 5 7 4
4 9 0 <-> 4 7 4
4 9 7 <-> 3 7 4
4 9 6 <-> 2 7 4
4 9 5 <-> 1 7 4
4 9 4 <-> 0 7 4





