8
4
2 1
24 29
- - - 0 0 - - - - - - - 0 0 0 0 0 0 0 0 0 - - - - - - - -
- - 0 0 0 0 0 - - - - 0 0 0 x x 0 0 0 0 0 - - 0 0 0 0 - -
- 0 0 0 0 0 0 0 0 - - 0 0 0 x x 0 0 0 b 0 0 - 0 0 0 0 0 -
0 0 x x 0 0 0 0 0 0 - - 0 0 0 0 0 0 0 0 0 0 - - 0 0 b 0 -
0 0 x x 0 0 0 c 0 0 - - 0 0 0 0 0 0 0 0 0 0 - - 0 0 0 0 0
0 0 0 0 0 0 0 0 0 0 - - 0 0 - 0 i 0 0 - - - - - 0 0 0 0 0
0 0 0 0 0 0 - 0 0 - - - - - - 0 0 0 0 - - 0 0 0 0 x x 0 0
0 0 0 0 0 - - - - - - - - 0 - - 0 0 - - - 0 0 0 0 x x 0 0
0 0 b 0 0 - - 0 - - 0 0 0 0 - - 0 0 - - 0 0 c 0 0 0 0 0 0
0 0 0 0 - - 0 0 0 0 0 0 b 0 0 - - - - - 0 0 0 0 0 0 0 0 -
- 0 0 0 - - 0 i 0 0 0 0 0 0 0 - - - - - - - - - - - - - -
- - 0 - - 0 0 0 0 0 0 0 0 0 0 - - 0 0 0 0 0 0 0 0 0 0 - -
- - - - - 0 0 0 0 x x 0 0 0 - - 0 0 b 0 0 0 0 0 0 0 0 - -
- - - - 0 0 0 0 0 x x 0 0 0 - - 0 0 0 0 x x 0 0 0 b 0 - -
- - - - 0 b 0 0 0 0 0 0 0 0 - - 0 0 0 0 x x 0 0 0 0 0 - -
- - - - 0 0 0 0 0 0 0 0 i 0 0 - - 0 0 0 0 0 0 0 - - - - -
- 0 0 - - 0 0 0 0 - 0 0 0 0 0 - - - - 0 0 0 - - - 0 0 - -
0 0 0 - - 0 0 - - - 0 0 0 - - - 0 0 - - - - - 0 0 0 0 - -
0 c 0 0 - - - - 0 - - - - - - - 0 0 0 0 - - 0 0 0 b 0 0 -
0 0 0 0 - - 0 0 0 - - - - - 0 0 0 0 0 0 - - 0 0 0 0 0 0 -
0 x x 0 0 0 0 0 0 0 - - 0 0 0 0 x x 0 0 - - 0 0 0 x x 0 -
0 x x 0 0 0 0 b 0 0 - - 0 b 0 0 x x 0 - - 0 0 c 0 x x 0 -
0 0 0 0 0 0 0 0 0 0 - - 0 0 0 0 0 0 0 - - 0 0 0 0 0 0 0 -
0 0 0 0 0 0 0 0 0 0 - - - - - - - - - - - - - - - - - - -
21 2 2 <-> 23 2 6
7 8 0 <-> 6 5 4
9 5 3 <-> 10 8 0
13 5 4 <-> 13 7 0
16 8 5 <-> 14 9 2
17 8 4 <-> 17 11 0
17 8 2 <-> 20 8 6
2 11 3 <-> 4 13 7
13 13 2 <-> 16 13 6
24 11 0 <-> 24 9 4
2 16 1 <-> 4 15 5
8 16 4 <-> 8 18 0
9 21 2 <-> 12 21 6
17 15 4 <-> 17 17 0
19 20 2 <-> 22 20 6
21 15 3 <-> 25 17 7