2
5
3 2
16 16
- - - - 0 0 0 0 0 0 0 0 - - - -
- - - 0 b 0 0 0 0 0 0 c 0 - - -
- - 0 0 0 0 0 0 0 0 0 0 0 0 - -
- 0 0 0 - - - 0 0 - - - 0 0 0 -
0 c 0 - 0 0 0 0 0 0 0 0 - 0 b 0
0 0 0 - 0 i 0 0 0 0 x 0 - 0 0 0
0 0 0 - 0 0 0 0 0 0 0 0 - 0 0 0
0 0 0 0 0 0 0 1 2 0 0 0 0 0 0 0
0 0 0 0 0 0 0 2 1 0 0 0 0 0 0 0
0 0 0 - 0 0 0 0 0 0 0 0 - 0 0 0
0 0 0 - 0 x 0 0 0 0 i 0 - 0 0 0
0 b 0 - 0 0 0 0 0 0 0 0 - 0 c 0
- 0 0 0 - - - 0 0 - - - 0 0 0 -
- - 0 0 0 0 0 0 0 0 0 0 0 0 - -
- - - 0 c 0 0 0 0 0 0 b 0 - - -
- - - - 0 0 0 0 0 0 0 0 - - - -
4 0 7 <-> 11 15 3
11 0 1 <-> 4 15 5
0 4 7 <-> 15 11 3
0 11 5 <-> 15 4 1
7 0 0 <-> 7 15 4
8 0 0 <-> 8 15 4
0 7 6 <-> 15 7 2
0 8 6 <-> 15 8 2

