2
5
3 2
16 16
- - - - 0 0 0 0 0 0 0 0 - - - -
- - - 0 b 0 0 0 0 0 0 c 0 - - -
- - 0 0 0 0 0 0 0 0 0 0 0 0 - -
- 0 0 0 - - - 0 0 - - - 0 0 0 -
0 c 0 - 0 0 0 0 0 0 0 0 - 0 b 0
0 0 0 - 0 i 0 0 0 0 x 0 - 0 0 0
0 0 0 - 0 0 0 0 0 0 0 0 - 0 0 0
0 0 0 0 0 0 0 1 2 0 0 0 0 0 0 0
0 0 0 0 0 0 0 2 1 0 0 0 0 0 0 0
0 0 0 - 0 0 0 0 0 0 0 0 - 0 0 0
0 0 0 - 0 x 0 0 0 0 i 0 - 0 0 0
0 b 0 - 0 0 0 0 0 0 0 0 - 0 c 0
- 0 0 0 - - - 0 0 - - - 0 0 0 -
- - 0 0 0 0 0 0 0 0 0 0 0 0 - -
- - - 0 c 0 0 0 0 0 0 b 0 - - -
- - - - 0 0 0 0 0 0 0 0 - - - -
4 0 3 <-> 11 15 7
11 0 5 <-> 4 15 1
0 4 3 <-> 15 11 7
0 11 1 <-> 15 4 5
7 0 4 <-> 7 15 0
8 0 4 <-> 8 15 0
0 7 2 <-> 15 7 6
0 8 2 <-> 15 8 6

