4
2
1 2
24 25
0 0 0 0 0 0 0 0 0 0 0 0 0 0 0 0 0 0 0 0 0 0 0 0 0
0 0 0 0 0 0 0 0 0 0 0 0 0 0 0 0 0 0 0 0 0 0 0 0 0
0 0 0 i 0 0 0 0 0 0 0 0 0 0 0 0 0 0 0 0 0 0 0 0 0
0 0 0 0 0 0 0 0 0 0 0 0 0 0 0 0 0 0 1 2 3 4 0 0 0
- - 0 0 0 0 0 0 0 0 0 0 0 0 0 0 0 0 4 1 2 3 0 0 0
- - - - 0 0 0 0 0 0 0 0 0 0 0 0 0 0 3 4 1 2 0 0 0
- - - - 0 0 0 0 0 0 0 0 0 0 0 0 0 0 2 3 4 1 0 0 0
- - - - - - - 0 0 0 0 0 0 0 0 0 0 0 0 0 0 0 0 0 0
- - - - - - - - - 0 0 0 0 0 0 0 0 0 0 0 0 0 0 0 0
- - - - - - - - - 0 0 0 0 0 0 0 0 0 0 0 0 0 0 0 0
0 0 0 - - - - - - - - - 0 0 0 0 0 0 0 0 0 0 0 0 0
0 0 0 0 0 - - - - - - - 0 0 0 0 0 0 0 0 0 0 0 0 0
0 b 0 0 0 - - - - - - - - - - 0 0 0 0 0 0 0 0 0 0
0 0 0 0 0 0 - - - - - - - - - 0 0 0 0 0 0 0 0 0 0
0 0 0 0 0 0 0 - - - - - - - - 0 0 0 0 0 0 0 0 0 0
0 0 0 0 b 0 0 0 0 0 - - - - - - - 0 0 0 0 0 0 0 0
0 0 0 0 0 0 0 0 0 0 0 0 - - - - - - 0 0 0 0 0 0 0
0 0 0 0 0 0 0 0 0 0 0 0 0 0 - - - - - 0 0 0 i 0 0
0 b 0 0 0 b 0 0 0 0 0 0 0 0 - - - - - - 0 0 0 0 0
0 0 x 0 x 0 0 0 b 0 0 0 0 0 0 0 - - - - 0 0 0 0 0
0 0 0 x 0 0 0 0 0 0 0 0 0 0 0 0 - - - - 0 0 0 0 0
0 0 x 0 x 0 0 0 0 0 0 0 0 0 0 0 - - - - - - - 0 0
0 b 0 0 0 b 0 0 0 b 0 0 0 b 0 0 0 - - - - - - - -
0 0 0 0 0 0 0 0 0 0 0 0 0 0 0 0 0 - - - - - - - -
4 6 4 <-> 4 11 0
4 6 5 <-> 4 11 1
4 6 6 <-> 4 11 2
12 11 4 <-> 11 16 0
12 11 5 <-> 11 16 1
12 11 6 <-> 11 16 2
20 20 4 <-> 15 19 0
20 20 5 <-> 15 19 1
20 20 6 <-> 15 19 2