3
2
0 1
29 29
- - - - - - - - - - - - 0 0 0 0 0 - - - - - - - - - - - -
- - - - - - - - - - 0 0 0 0 0 0 0 0 0 - - - - - - - - - -
- - - - - - - - 0 0 0 0 0 0 0 0 0 0 0 0 0 - - - - - - - -
- - - - - - 0 0 0 0 0 0 0 0 0 0 0 0 0 0 0 0 0 - - - - - -
- - - - 0 0 0 0 0 0 - 0 0 0 - 0 0 0 - 0 0 0 0 0 0 - - - -
- - - - 0 x 0 0 0 - b - 0 0 c 0 0 - b - 0 0 0 x 0 - - - -
- - - 0 0 0 0 0 0 0 - 0 0 0 - 0 0 0 - 0 0 0 0 0 0 0 - - -
- - - 0 0 0 0 0 0 0 0 0 0 0 0 0 0 0 0 0 0 0 0 0 0 0 - - -
- - 0 0 0 0 0 0 0 0 0 0 0 0 0 0 0 0 0 0 0 0 0 0 0 0 0 - -
- - 0 0 0 - 0 0 0 - - - 0 0 0 0 0 - - - 0 0 0 - 0 0 0 - -
- 0 0 0 - b - 0 0 - - - 0 0 0 0 0 - - - 0 0 - b - 0 0 0 -
- 0 0 0 0 - 0 0 0 - - - 0 0 0 0 0 - - - 0 0 0 - 0 0 0 0 -
0 0 0 0 0 0 0 0 0 0 0 0 0 0 0 0 0 0 0 0 0 0 0 0 0 0 0 0 0
0 0 0 0 0 0 0 0 0 0 0 0 0 1 2 3 0 0 0 0 0 0 0 0 0 0 0 0 0
0 0 0 0 - c - 0 0 0 0 0 0 2 3 1 0 0 0 0 0 0 - c - 0 0 0 0
0 0 0 0 0 0 0 0 0 0 0 0 0 3 1 2 0 0 0 0 0 0 0 0 0 0 0 0 0
0 0 0 0 0 0 0 0 0 0 0 0 0 0 0 0 0 0 0 0 0 0 0 0 0 0 0 0 0
- 0 0 0 0 - 0 0 0 - - - 0 0 0 0 0 - - - 0 0 0 - 0 0 0 0 -
- 0 0 0 - b - 0 0 - - - 0 0 0 0 0 - - - 0 0 - b - 0 0 0 -
- - 0 0 0 - 0 0 0 - - - 0 0 0 0 0 - - - 0 0 0 - 0 0 0 - -
- - 0 0 0 0 0 0 0 0 0 0 0 0 0 0 0 0 0 0 0 0 0 0 0 0 0 - -
- - - 0 0 0 0 0 0 0 0 0 0 0 0 0 0 0 0 0 0 0 0 0 0 0 - - -
- - - 0 0 0 0 0 0 0 - 0 0 0 - 0 0 0 - 0 0 0 0 0 0 0 - - -
- - - - 0 x 0 0 0 - b - 0 0 c 0 0 - b - 0 0 0 x 0 - - - -
- - - - 0 0 0 0 0 0 - 0 0 0 - 0 0 0 - 0 0 0 0 0 0 - - - -
- - - - - - 0 0 0 0 0 0 0 0 0 0 0 0 0 0 0 0 0 - - - - - -
- - - - - - - - 0 0 0 0 0 0 0 0 0 0 0 0 0 - - - - - - - -
- - - - - - - - - - 0 0 0 0 0 0 0 0 0 - - - - - - - - - -
- - - - - - - - - - - - 0 0 0 0 0 - - - - - - - - - - - -
3 6 0 <-> 6 3 6
22 3 2 <-> 25 6 0
8 8 3 <-> 16 16 3
12 12 7 <-> 20 20 7
16 12 1 <-> 8 20 1
20 8 5 <-> 12 16 5
3 22 4 <-> 6 25 6
25 22 4 <-> 22 25 2