2
3
2 0
8 8
- - - 1 - - - -
0 0 0 1 2 0 0 0
0 0 0 1 2 0 0 0
0 0 0 1 2 0 0 0
0 0 0 1 2 0 0 0
0 0 0 1 2 0 0 0
0 0 0 1 2 0 0 0
- - - - 2 - - -
3 0 7 <-> 0 1 0
3 0 6 <-> 1 1 0
3 0 5 <-> 2 1 0
3 0 3 <-> 4 1 0
3 0 2 <-> 5 1 0
3 0 1 <-> 6 1 0
3 0 0 <-> 7 1 0

4 7 4 <-> 0 6 4
4 7 5 <-> 1 6 4
4 7 6 <-> 2 6 4
4 7 7 <-> 3 6 4
4 7 1 <-> 5 6 4
4 7 2 <-> 6 6 4
4 7 3 <-> 7 6 4

0 1 6 <-> 7 1 2
0 2 6 <-> 7 2 2
0 3 6 <-> 7 3 2
0 4 6 <-> 7 4 2
0 5 6 <-> 7 5 2
0 6 6 <-> 7 6 2



